#############################################################
#                                                           #
#                                                           #
#                                                           #
#                ######                                     #
#                                                           #
#         #####         #######                             #
#                                                           #
#                                                           #
#   #####                                                   #
#                                                           #
#                   #####                                   #
#                                                           #
#                            ######                         #
#          ####                                             #
#                                                           #
#                                                           #
#                                                           #
#      ####                                #######          #
#                                                           #
#                                                           #
#                    ######                                 #
#                                            #####          #
#                                                           #
#   #######                                                 #
#                                                           #
#                                                           #
#                        #####                              #
#                 #####                                     #
#                                                           #
#       #####                              #####            #
#                                 #####                     #
#                                 #####          P          #
#############################################################
#############################################################
#############################################################
#############################################################
#############################################################
#############################################################
#############################################################

